1111111111111111111
1000000000000000001
1000000000000C00001
10000M0P000M0000111
101C1000111110000E1
1111111111111111111