1111111111111111111
1000000000000000001
1000000P00000C00001
100C000011111000C01
1111111111111111111
