1111111111111111111111111
1C00000CCCC0000000C000001
1011111111110111111111111
1011111111110111110000001
1011111111110111111111111
1P11100000C000000000000E1
1111111111111111111111111