1111111111111111111
1000000000000000001
1000000P00000C00001
10000M00000M0000111
100C000011111000CE1
1111111111111111111
